3 3 511 5509 6968 
3 4 6968 3612 3414 4395 
3 4 4395 7073 723 5868 
3 6 5868 7062 5490 3918 3042 5677 
3 5 511 6998 7012 5192 7057 
3 6 7057 7059 7063 7094 7132 450 
3 8 450 1359 4289 3921 7319 5893 7380 6054 
3 2 6054 7451 
3 4 6054 4768 7406 7430 
3 4 7430 3269 4024 7466 
3 4 4376 5021 566 3269 
3 6 723 4650 7177 7202 7236 4376 
3 4 7202 7182 5110 3921 
3 5 1849 7710 3835 7634 7602 
2 6 7557 4741 7620 7679 2806 5297 
2 5 5297 2814 7737 7718 7656 
2 6 7656 7594 7591 7558 7541 7557 
1 3 1179 7483 7557 
1 5 1179 7303 2549 7240 7222 
1 4 7042 2817 7124 5677 
2 4 5677 4436 7201 2697 
1 6 2697 7278 7241 5082 7212 7222 
2 6 1849 7744 7706 2365 5741 7656 
2 7 1849 7812 7853 7879 7930 4911 8053 
2 4 2626 5035 362 3857 
2 4 3857 8145 8120 5609 
2 6 5609 5888 4935 8170 8116 8053 
2 2 7952 7930 
2 5 7952 7951 1410 8039 362 
1 6 2326 7832 5266 3662 5083 7812 
2 6 274 7420 1991 7495 2840 7602 
2 7 5490 1159 7152 7192 3087 4657 274 
2 9 511 1392 6984 3360 7010 6999 4161 42 1975 
3 9 7762 7791 4196 2996 7683 5919 2948 7638 7602 
1 4 7762 7821 7892 5042 
1 5 3707 8066 8032 7994 5042 
2 5 3707 8117 8093 8080 8053 
2 6 288 2492 7213 7179 1212 450 
3 5 7762 7804 1344 5946 2140 
3 4 2140 7909 7937 2930 
3 9 2930 7910 2685 7911 5900 6075 7847 1919 4499 
3 4 4499 7932 2715 8073 
1 4 4370 8036 7985 2930 
1 4 2113 417 7868 2685 
1 9 7602 7568 3453 7520 7559 5861 4862 5884 7558 
2 4 8288 3805 8216 2297 
2 6 3707 8153 8179 8203 8246 8288 
1 5 5042 8002 5486 5567 2297 
1 4 4370 8122 8157 4520 
2 3 8163 8238 4520 
2 5 4520 8223 4066 8213 2297 
2 6 8288 282 5089 5708 5372 8610 
2 4 8610 8600 2162 986 
2 4 986 5658 4827 8726 
2 2 8744 8726 
2 6 8726 8736 4618 8750 3880 5662 
2 3 970 8820 5662 
3 5 2042 3729 2321 4341 8726 
3 2 2321 4618 
1 6 4066 4734 1755 4800 3558 2162 
2 8 5662 5945 4589 8877 4154 8842 3817 2745 
2 5 6043 8978 8960 2500 2745 
2 3 4589 5030 6043 
2 6 5340 9029 2841 4490 3985 8960 
2 6 5340 2348 962 3001 4352 3427 
2 4 2745 4829 8938 3001 
2 6 3427 8858 3797 8857 8843 3817 
2 5 4195 8752 4264 8809 8842 
1 4 4195 1147 3016 4044 
2 5 4044 8469 1077 2667 2042 
1 6 8163 4474 5152 3829 4910 1077 
1 7 4195 1218 4967 8745 8778 8815 3427 
1 6 7628 1048 3660 568 7769 4499 
1 6 3660 7658 7672 2289 3048 5867 
1 6 7628 7597 5400 5444 7484 7451 
1 7 3140 7298 7271 5959 7227 7214 288 
1 8 3140 3976 2344 2476 7463 3413 5483 4002 
1 3 5643 2149 2344 
3 2 3525 2496 
3 3 1094 7795 2496 
3 4 7826 7808 1715 2496 
3 5 7986 7953 7912 3317 7826 
3 4 7986 4496 5934 1094 
3 3 3525 6089 4002 
3 3 1094 7840 5867 
2 6 4721 1887 3580 3680 2242 7826 
2 2 3525 3680 
2 4 4499 4160 7875 5867 
2 4 5867 423 8023 8073 
2 7 7986 7995 3106 7981 8024 8009 8023 
1 4 8073 2758 5850 4044 
2 4 1899 1055 2350 6991 
2 6 7045 6004 3938 5877 1109 6991 
2 2 2350 1109 
2 7 1899 6048 7033 7044 7060 7055 2413 
2 4 7135 7166 2308 5643 
2 3 5495 7293 7258 
2 4 7537 7564 2887 4721 
2 4 5495 2335 7492 7537 
2 2 7492 2887 
2 6 7258 2722 5621 504 3977 2413 
2 6 7258 7229 7218 7167 1327 3938 
2 5 2413 7049 3511 208 1975 
2 6 2413 7135 3725 7120 2408 7082 
3 3 2534 1083 9563 
3 4 9523 634 9517 2534 
3 4 2534 2114 1171 6065 
2 4 6065 4957 3200 5535 
2 3 1083 1062 9535 
2 3 2999 4634 11344 
2 4 9508 11345 5175 2999 
2 5 2999 2016 4456 2712 5535 
2 5 9535 9524 1826 9499 2712 
2 5 11344 2261 9536 9533 9535 
2 4 9508 3304 4727 3654 
2 6 3654 5924 9579 517 1660 618 
2 4 2444 9634 9638 1286 
2 3 1286 9651 2006 
1 5 11344 2085 2541 2451 1660 
1 4 11344 206 9582 2076 
1 5 2076 516 5878 2542 9563 
1 6 4657 7316 1555 7304 7313 4376 
3 5 7466 439 7552 7576 7602 
4 9 8902 8918 5048 8928 8934 3865 4235 4850 9062 
4 4 9062 9094 9114 6047 
4 3 9128 1557 458 
4 7 6047 9191 1168 4321 715 3910 9128 
4 3 458 5787 715 
4 5 458 9222 524 9067 2364 
4 3 2364 2608 2356 
4 4 8854 4934 8935 2356 
4 10 9128 1984 2976 9017 2183 4937 418 8856 5003 855 
4 4 8854 3178 8803 855 
4 2 4377 418 
4 2 2356 9017 
4 3 855 1665 8711 
4 4 458 9277 9326 4949 
4 5 9191 4724 9278 4108 4709 
4 8 9062 4259 2615 9083 1436 5362 9196 5825 
4 6 5825 6070 3970 3477 3543 9333 
4 6 3543 9318 394 2573 9353 4709 
4 3 4709 9352 5051 
4 8 5051 9365 1865 1980 9328 467 9351 4949 
3 10 1002 400 4098 8868 4144 4471 3017 8876 8886 8902 
3 5 400 246 8977 202 4235 
3 3 2291 8494 3504 
3 4 3504 2611 3214 210 
2 4 210 1842 8013 5476 
2 6 7519 2174 7775 7828 4398 5476 
2 2 4398 8013 
2 6 7228 7269 7348 1977 2300 7519 
1 5 2291 4883 8406 8385 8386 
2 5 2300 1726 429 5259 4539 
2 4 3438 2200 5348 4539 
2 6 8759 380 8625 134 8315 210 
2 3 8759 936 8942 
2 4 9087 139 5057 8942 
2 5 5660 1775 3434 1538 8759 
2 5 9276 2787 9208 2092 997 
3 6 9401 4797 9420 9425 2023 3965 
2 4 3965 4433 376 3576 
2 5 9276 2935 5182 9317 3576 
2 6 1067 1228 5031 191 997 9087 
4 6 8711 3073 8674 4953 8527 3504 
1 6 2549 5547 2051 3246 4919 7228 
2 4 7519 1501 3914 4741 
2 5 5476 4642 5425 2313 5297 
2 4 3504 1379 3291 3857 
1 6 8170 8209 8236 4014 8335 8386 
1 6 8236 8259 8210 8189 1568 3707 
2 4 4912 4892 3451 5660 
1 7 4539 5943 3906 7922 2045 4522 985 
1 4 2045 5763 1960 8298 
2 4 985 2235 5250 159 
2 8 8298 4349 8376 518 2471 8577 144 1775 
2 7 5250 5562 496 8277 8350 1153 8413 
2 5 144 3057 1861 828 1153 
2 4 828 332 247 4912 
2 15 9276 9256 9241 9213 4648 9185 2769 9169 9143 9154 3275 239 35 2644 3978 
4 6 2879 8716 8741 5189 5217 4483 
4 4 4483 4914 3494 4923 
4 4 1102 2158 140 4923 
4 6 140 5940 8852 2232 8923 1395 
4 3 2232 4332 1736 
4 3 9020 2757 1736 
3 4 2757 313 9051 1898 
3 8 1898 2272 9055 1940 4053 3503 3289 9106 
3 2 1722 4053 
3 6 9106 1643 5341 758 2264 2481 
3 9 1102 8730 4731 8775 4445 2538 2197 655 5170 
3 5 5170 8709 8710 235 8714 
2 7 2538 4569 8825 3135 2809 756 1898 
2 4 4731 4818 2533 1736 
2 7 3978 494 9203 544 3190 9243 9255 
2 5 9203 9217 9224 9253 3882 
2 5 3882 2695 2353 9226 1925 
3 5 9141 3920 9186 4786 1925 
2 6 2481 4040 9240 223 3416 1925 
2 12 1643 1037 9036 1819 2506 4295 734 8999 9056 4126 1646 9141 
2 8 2506 8872 2692 44 8862 980 4629 8714 
1 6 118 4690 3671 5450 3564 8872 
1 8 247 5548 358 4113 2124 3545 8349 4604 
1 2 8405 4113 
1 11 3545 3540 8436 4068 4830 1533 3848 931 717 8654 118 
1 2 3848 2166 
1 7 2166 788 3141 8834 8893 126 4295 
2 5 35 2088 5147 4968 11350 
2 10 788 8760 2407 3029 11350 11349 11351 1013 8776 4912 
2 2 936 5057 
3 4 2109 4437 9427 3965 
3 5 4949 4593 425 9367 3532 
3 5 9401 3755 9396 3532 1067 
1 8 8711 8702 8680 8643 5793 3342 8468 8386 
1 9 8194 8280 365 4546 8476 3409 5812 8630 8654 
2 4 6939 1911 6980 6996 
2 9 6996 2216 7034 7074 4230 7146 7172 7207 7228 
1 14 2224 1304 7312 3461 7295 1443 7318 3393 993 1333 3826 5022 3265 4539 
3 6 2373 1198 8017 3891 4400 2961 
3 6 7531 2215 3845 5846 5961 875 
3 4 7419 7386 2957 5961 
3 7 5116 3535 5957 5881 7636 2993 2215 
3 4 5116 290 1454 7419 
3 7 7636 901 5395 7836 7904 1614 4430 
3 3 653 7974 1614 
3 9 653 5264 8038 8095 1164 8069 5113 8070 8091 
3 7 2961 7966 5885 7917 5630 8005 8091 
2 7 2373 1924 5775 4035 902 7494 2224 
2 2 2224 536 
2 3 4035 7640 3988 
3 7 3988 7585 2330 2647 7580 7524 290 
3 4 5885 2588 77 3988 
2 7 2957 6018 2286 7225 2896 3765 4887 
2 6 2896 6021 1449 7011 639 4153 
3 5 2961 8077 8096 8136 8195 
1 4 8195 2057 8314 3545 
2 3 4456 2257 2109 
2 3 9523 9538 4716 
2 3 9563 937 325 
2 2 9651 3673 
2 4 618 9610 5324 2444 
2 24 4153 5367 1756 18 669 1162 6914 1064 6934 1503 4447 6921 1543 6911 575 6861 6843 1181 2008 1368 4606 5355 2898 6855 
2 12 5860 6614 4890 587 2318 6710 6731 5088 6840 6878 1583 1756 
2 19 6939 6943 5933 6949 4297 5519 5954 6967 4873 1063 2576 1838 6942 636 5426 1275 2484 6856 6840 
1 4 2576 5357 3652 7295 
1 8 8315 663 8429 996 4837 8334 8333 8298 
2 6 5031 2406 2489 507 9104 2364 
1 4 8942 657 9010 2489 
1 4 8862 1381 4064 1037 
2 3 6872 6866 6855 
3 2 875 4601 
3 2 7531 4274 
3 2 1102 8718 
2 2 1722 9140 
3 2 9333 9336 
2 2 7222 7200 
1 2 1443 7347 
2 4 1669 1404 4497 3792 
2 4 1669 9485 2698 9505 
2 5 3792 3644 2839 9 9505 
1 3 2839 554 9584 
