1 43 511 5509 3612 3414 4395 7073 723 5868 7062 5490 3918 3042 5677 4436 7201 2697 7278 7241 5082 7212 7222 7240 2549 7303 1179 7483 7557 7541 7558 4180 7594 7656 5741 2365 7680 7706 7744 1849 7812 5083 7838 7879 7952 
1 4 8053 4911 7930 7879 
1 5 8053 8080 8093 8117 3707 
1 10 511 6998 7012 5192 7057 7059 7063 7094 7132 450 
1 8 450 1359 4289 3921 7261 1979 5021 4376 
1 6 450 1212 7179 7213 2492 288 
1 8 7057 5655 5065 7119 7138 4333 7214 288 
1 3 5490 6000 7062 
1 11 6000 7152 7192 3087 4657 274 7420 1991 7495 2840 7602 
1 9 7602 7574 7536 7510 4678 7466 4024 3269 7430 
1 3 5021 566 3269 
1 4 6054 4768 7406 7430 
1 6 4376 7236 7202 1596 4650 723 
1 6 4376 7313 7304 1555 7316 4657 
1 13 4180 4862 5861 7559 5488 1634 7568 7602 7638 4763 7738 7756 1849 
1 8 3707 8066 8032 7994 5042 7892 7821 7762 
1 8 7762 5968 7715 5754 7683 5919 2948 7638 
1 5 3921 7305 5172 7380 6054 
1 5 4395 7096 3502 7140 450 
1 9 511 1392 6984 3360 7010 6999 4161 7014 1975 
1 2 7930 7952 
1 6 5297 2806 7679 7620 4741 7557 
1 5 5297 2814 7737 7718 5741 
1 8 5888 5609 8120 8145 3857 362 5035 2626 
1 4 5035 1410 7951 7952 
1 5 8053 8116 8170 4935 5888 
